[
  {
    "time_limit": 10,
    "max_moves": 12,
    "maze": [
      "#######",
      "#S    #",
      "### ###",
      "#     #",
      "# ### #",
      "#   E##",
      "#######"
    ]
  },
  {
    "time_limit": 12,
    "max_moves": 17,
    "maze": [
      "#########",
      "#S #   E#",
      "# ### ###",
      "# #     #",
      "# # #####",
      "#       #",
      "#########"
    ]
  },
  {
    "time_limit": 16,
    "max_moves": 52,
    "maze": [
      "################",
      "#S #      #E   #",
      "# ### #n## ### ##",
      "#   #   #   #  #",
      "### # ### # # ##",
      "#     #   #    #",
      "# ##### ### ####",
      "#              #",
      "################"
    ]
  }
]
