[
    {
        "id": 1,
        "max_moves": 30,
        "time_limit": 60,
        "maze": [
            "########",
            "#      #",
            "#  ### #",
            "#  S#E #",
            "########"
        ]
    }
]
