[
    {
        "id": 1,
        "maze": [
            "########",
            "#S     #",
            "#  ##  #",
            "#   #E #",
            "########"
        ]
    }
]
